nom:demo
meilleurscore:210
nbcolonne:20
nbligne:15
C-C-C-C-C-C-C-C-C-C-C-C-C-C-C-C-C-C-C-C
C-C-C-C-C-C-C-C-C-C-C-C-C-C-C-C-C-C-C-C
C-C-C-C-C-C-C-C-C-C-C-C-C-C-C-F3-C-C-C-C
C-C-C-C-C-C-C-C-C-C-C-C-C-C-C-C-C-C-C-C
C-C-C-C-C-F2-C-C-C-C-C-C-C-C-C-C-C-C-C-C
C-C-C-C-C-C-C-C-C-C-C-C-C-C-C-C-C-C-C-C
C-C-C-C-C-C-C-C-C-C-C-C-C-C-C-C-C-C-C-C
C-M-C-C-C-C-S-C-C-C-C-F1-C-C-C-C-C-C-C-C
C-C-C-C-C-C-S-C-C-C-C-C-C-C-C-C-C-C-C-C
C-M-C-G-C-C-S-C-C-C-C-C-C-C-C-C-C-C-C-C
C-M-C-G-C-C-S-C-C-C-C-C-C-C-C-C-C-C-C-C
C-M-C-G-C-C-S-C-C-C-C-P-C-C-C-C-C-C-C-C
C-C-C-C-C-C-C-C-C-C-C-C-C-C-C-C-C-C-C-C
C-C-C-C-C-C-C-C-C-C-C-C-C-C-C-C-C-C-C-C
C-C-C-C-C-C-C-C-C-C-C-C-C-C-C-C-C-C-C-C
