nom:niveau-3
meilleurscore:580
nbcolonne:20
nbligne:15
M-M-M-M-M-M-M-M-M-M-M-M-M-M-M-M-M-M-M-M
M-C-C-C-C-C-C-C-C-C-C-C-C-C-C-C-M-C-C-M
M-M-M-M-M-G-G-M-M-C-C-F3-C-C-C-C-C-C-C-M
M-C-C-C-C-G-C-C-C-C-C-C-M-M-M-C-C-M-M-M
M-M-M-M-M-G-C-G-C-C-G-G-G-C-C-F1-C-M-C-M
M-C-C-S-G-G-M-M-C-M-M-G-G-C-C-C-C-M-C-M
M-C-C-G-G-G-M-C-C-C-M-G-G-C-S-C-C-M-C-M
M-M-M-G-G-G-M-M-M-M-M-G-C-C-C-C-C-C-C-M
M-C-C-G-G-G-G-G-G-G-G-G-G-C-M-M-C-M-C-M
M-C-C-C-M-G-G-G-S-G-G-C-G-C-M-M-C-M-C-M
M-C-C-C-M-G-M-G-G-G-G-G-M-C-C-C-C-M-C-M
M-M-M-M-M-G-M-M-C-P-C-M-M-C-M-M-M-M-C-M
M-C-C-C-C-G-C-C-C-C-C-C-C-C-C-C-C-C-C-M
M-C-C-C-C-M-C-C-M-C-C-M-C-C-C-C-F2-C-C-M
M-M-M-M-M-M-M-M-M-M-M-M-M-M-M-M-M-M-M-M
