nom:testEnregistrer
meilleurscore:0
nbcolonne:20
nbligne:15
M-C-C-C-C-C-C-C-C-C-C-C-C-C-C-C-C-C-C-C
C-C-C-C-C-C-C-C-C-C-C-C-C-C-C-G-C-C-C-C
M-C-C-G-C-C-C-C-C-C-C-C-C-C-C-C-C-C-C-C
C-C-C-C-C-C-C-C-C-F1-C-C-C-C-C-C-C-C-C-C
C-C-C-C-C-C-C-C-C-C-C-C-C-C-C-G-C-C-C-C
M-C-C-C-C-C-C-C-C-C-C-C-C-C-C-C-C-C-C-C
C-C-C-C-C-F2-C-C-C-C-C-C-C-C-F3-C-C-C-C-C
C-C-C-C-C-C-C-C-C-C-C-C-C-C-C-C-C-C-C-C
C-C-C-C-C-C-C-C-C-C-C-C-C-C-C-C-C-C-C-C
M-C-C-M-C-C-C-C-C-S-C-C-C-C-C-C-C-C-C-C
C-C-C-C-C-C-C-C-C-C-C-C-C-C-C-C-C-C-C-C
C-C-C-C-C-C-C-C-C-P-C-C-C-C-C-C-C-C-C-C
C-C-C-C-C-C-C-C-C-C-C-C-C-C-C-C-C-C-C-C
C-C-C-C-C-C-C-C-C-C-C-C-C-C-C-C-C-C-C-C
C-C-C-C-C-C-C-C-C-C-C-C-C-C-C-C-C-C-C-C
